NO ./textures/BrickOv.xpm
SO ./textures/Bricks.xpm
EA ./textures/Glass.xpm
WE ./textures/Gold0.xpm
F 24,26,33
C 98,188,227

111111
100001
1000N1
11111111111111
        100001
        100001
        100001
        111111
