NO ./textures/north.xpm
SO ./textures/south.xpm
EA ./textures/east.xpm
WE ./textures/west.xpm
F 220,100,0
C 225,30,0

111111
1000C1
1W00N1
111111
