NO ./textures/BrickOv.xpm
SO ./textures/Bricks.xpm
EA ./textures/Glass.xpm
WE ./textures/Gold0.xpm

C 24,24,24
F 12,12,12

111111111111111111111111111
1011000001110000000000001
1001000000000000000000001
111111111011000001110000111111111
100000000011000001110111111111111
11110011111111000000000010001
11110111111111011101010010001
11000000110101011100000000001
11111111111111111101111111111
                 101
                 101
11111111111111111101111111111
10000000000000000000000000001
11000001110101011111011110N011
11110111 1110101 101111010001
11111111 1111111 111111111111
